P,B,B,B,B,B,B,B
T,B,B,B,B,B,B,B
B,B,B,B,B,T,B,B
B,B,B,T,B,B,B,B
B,B,B,P,B,B,B,B
T,B,P,P,P,B,P,B
B,B,B,P,B,B,B,B
S,P,B,P,B,B,B,B
0,0,0,0,0,0,0,~
P,B,B,B,B,B,B,B
P,P,B,B,B,B,B,B
B,P,B,B,B,P,B,P
T,P,B,B,B,B,B,B
B,P,P,B,B,B,B,B
B,B,B,B,B,B,B,B
B,B,B,B,B,B,T,B
B,B,P,B,C,B,P,B
0,0,0,0,0,0,0,~
P,B,B,P,B,C,B,G
P,B,P,P,B,B,B,P
B,B,B,P,B,B,B,C
B,B,B,B,B,B,P,P
B,B,B,B,B,B,P,B
B,B,B,B,P,B,P,B
B,B,P,B,P,B,B,B
B,B,P,P,B,P,B,B
0,0,0,0,0,0,0,*
